NO ./img/TECH_0B.xpm
SO ./img/TECH_0B.xpm
WE ./img/TECH_0A.xpm
EA ./img/TECH_OA.xpm

F1 ./img/front1.xpm
F2 ./img/front2.xpm
F3 ./img/front3.xpm
F4 ./img/front4.xpm

A1 ./img/attack1.xpm
A2 ./img/attack2.xpm
A3 ./img/attack3.xpm

D1 ./img/die1.xpm
D2 ./img/die2.xpm
D3 ./img/die3.xpm

B ./img/BARREL.xpm
C ./img/CABLES_1.xpm

F 25,25,27
C 18,18,18

111111111111111111111111111111111
100000000011000000000000111111111
100000W00111000000000000111111111
100100000000000000000000111111111
100000000011000001110000000000001
100000000011000001110111111111111
111101111111110111000000100011111
111101111111110111010100100011111
110000001101010111000000100011111
100000000000000011000000100011111
100000000000000011010100000011111
110000011101010111110111100011111
111101111111010111011110100011111
111111111111111111111111111111111
