NO ./img/north.xpm
SO ./img/south.xpm
WE ./img/west.xpm
EA ./img/east.xpm

F 87,213,59
C 116,208,241

111111111111111111111111111111111
100000000011000000000000111111111
100000W00111000000000000111111111
100100000000000000000000111111111
100000000011000001110000000000001
100000000011000001110111111111111
111101111111110111000000100011111
111101111111110111010100100011111
110000001101010111000000100011111
100000000000000011000000100011111
100000000000000011010100000011111
110000011101010111110111100011111
111101111111010111011110100011111
111111111111111111111111111111111
