NO ./img/TECH_0A_dark.xpm
SO ./img/TECH_0A_dark.xpm
WE ./img/TECH_0A.xpm
EA ./img/TECH_0A.xpm

F 55,50,50
C 18,18,18

1111111    111111111
  1010111111011100101
 10000100S01000000101
 11000000000011100001
100011100001010111001
 10011111011100011001
10000001100010001101
 1101101001001010001
 100010001 101010001
 100010111110001111
  111 1     111
