NO ./img/bricks.xpm
SO ./img/wood.xpm
WE ./img/MARBFAC2.xpm
EA ./img/STONE3.xpm

F 87,213,59
C 116,208,241

1111111111111111111111111
1000000000110000000000001
1011000001110000000000001
1001000000000000000000001
111111111011000001110000000000001
100000000011000001110111111111111
111101111111110111000000100011111
111101111111110111010100100011111
110000001101010111000000100011111
100000000000000011000000100011111
100000000000000011010100100011111
11000001110101011111011110N011111
111101111111010111011110100011111
111111111111111111111111111111111
