NO ./img/bricks.xpm
SO ./img/wood.xpm
WE ./img/MARBFAC2.xpm
EA ./img/STONE3.xpm

F 87,213,59
C 116,208,241

1111111111111111111111111
1000000000110000000000001
1011000001110000000000001
100100000000000000000000111111111
111111111011000001110000000000001
100000000011000001110111111111111
11110111111111011100000010001
  110111111111011101010010001
11000000110101011100000010001
10000000000000001100000010001
10000000000000001101010010001
11000001110101011111011110N01
  110111111101011101111010001
  111111111111111111111111111
