NO ./img/north.xpm
SO ./img/south.xpm
WE ./img/west.xpm
EA ./img/east.xpm
DO ./img/bricks.xpm

F 140,140,140
C 0,0,0

111111111111111111111111111111111
100000000011000000000000111111111
1011000001110000D0000000111111111
100D00000000000000000000111111111
111111111011000001110000000000001
10000000001100000111011111D111111
111101111111110111000000100011111
111101111111110111010100100011111
110000001101010111000000100011111
10000000000000001100000010W011111
100000000000000011010100000011111
110000011101010111110111100011111
111101111111010111011110100011111
111111111111111111111111111111111
