NO ./img/lab/LAB_1A_dark.xpm
SO ./img/lab/LAB_1A_dark.xpm
WE ./img/lab/LAB_1A.xpm
EA ./img/lab/LAB_1A.xpm

DO ./img/lab/DOOR_4B.xpm
W2 ./img/lab/LAB_1A.xpm
W3 ./img/lab/LAB_1A.xpm
W4 ./img/lab/LAB_1A.xpm
W5 ./img/lab/LAB_1A.xpm
W6 ./img/lab/LAB_1A.xpm
W7 ./img/lab/LAB_1A.xpm
W8 ./img/lab/LAB_1A.xpm
W9 ./img/lab/LAB_1A.xpm

F0 ./img/lab/front0R.xpm
F1 ./img/lab/front1R.xpm
F2 ./img/lab/front2R.xpm
F3 ./img/lab/front3R.xpm

A0 ./img/lab/attack0R.xpm
A1 ./img/lab/attack1R.xpm
A2 ./img/lab/attack2R.xpm
A3 ./img/lab/attack3R.xpm

D0 ./img/lab/die0R.xpm
D1 ./img/lab/die1R.xpm
D2 ./img/lab/die2R.xpm
D3 ./img/lab/die3R.xpm

BA ./img/lab/BARREL2.xpm
CA ./img/lab/CABLES_1.xpm
PV ./img/lab/health_v2.xpm

F 5,10,5
C 17,18,17

                             1111111111111
     111111                  1000000000001
     100001      11111111111110000000000011111
     1000011     10000000000010000000000010001
     1000011     100000000000D00000000000D0001
     1000001     10000000000010000000000010001
     11111D11111 10001111111110000000000011111
     10000000001 10001       1000000000001
     1000000000111000111     111111D111111
     1000000000100000001         10001
     1000000000D00000001         10001
     1000000000100000001         10001
111111000000000111111111         10001
1000110000000001                 10001
1000111111D11111            111111000111
10001   10001               11000D000D01
11D11   10001               100111000111
1000111110001               1001110001
1000100010001               1001110001
1000000010001               1111110001
1000100010001                    10001
1000111111D11111                111D111               1111111111
1000110000000001           111111000001111111         1000000001
1000110000000001           100000000000000011         1000000001
1000110000000001           1000000000000000111111111111000000001
1000010000000001           1000000000000000010000000001000000001
10000D0000000001           10000000000000000D000000000D000000001
1000010000000001           1000000000000000010000000001000000001
1000110000000001           1000000000000000111100001111000000001
1000110000000001           1000000000000000111110011  1000000001
1000110000000001           11111100000111111   1001   1000000001
1000111111D11111                111D111        1001   1110110111
1000111110001                    10001         1001     111111
1000111110001                    10001         1001
1000100010001                    10001         1001 111111111
1000D00010001                    10001         100111010101011
1000100010001                    10001         100010000000001
1000111110001                    10001         1000D0000000001
10001111100011111111111111       10001         100010000000001
1000000000000000010000000111     10001         111111010101011
10000000000000000D0000000001     10001              111111111
1000000000000000010000000111     10001
111111111111111111D1111111       10001
         111001100001       1111111D1111111
         100001001111       100001000100001
         11100000111        10000D000D00001
           1110111          100001000100001
            1001            100001000100001
            1011            111111000111111
            1111            100001000100001
                            10E00D000D00001
                            100001000100001
                            111111000111111
                            100000000000001
                            100000000000R01
                            100000000000001
                            111111111111111
