NO ./img/space_ship/TECH_0A_dark.xpm
SO ./img/space_ship/TECH_0A_dark.xpm
WE ./img/space_ship/TECH_0A.xpm
EA ./img/space_ship/TECH_0A.xpm

DO ./img/DOOR_2C.xpm
W2 ./img/CONSOLE_1A.xpm
W3 ./img/CONSOLE_1A.xpm
W4 ./img/VENT_1B.xpm
W5 ./img/TECH_2B.xpm
W6 ./img/GRID_2B.xpm
W7 ./img/LIGHT_1B.xpm
W8 ./img/SUPPORT_1D.xpm
W9 ./img/PIPES_2A.xpm

F0 ./img/front1.xpm
F1 ./img/front2.xpm
F2 ./img/front3.xpm
F3 ./img/front4.xpm

A0 ./img/attack1.xpm
A1 ./img/attack1.xpm
A2 ./img/attack2.xpm
A3 ./img/attack3.xpm

D0 ./img/die1.xpm
D1 ./img/die2.xpm
D2 ./img/die4.xpm
D3 ./img/die5.xpm

BA ./img/BARREL2.xpm
CA ./img/CABLES_1.xpm
PV ./img/health_v2.xpm

F 55,50,50
C 18,18,18

111111111111151111111
110000111111B0C0000C11
110C00190111B0000W00D01
110700D0000DR0113100101
1B0000100C01B11111001C1
110001161D1111111100101
100C00011000011111D1101
111D111100C00111BC011C1
1100081101D10111BRC1101
110H0111110011111111101
111111111100000C0000001
110C0000011011111111111
1100000000001
11B00000B1111
11BR0000011
11B000C0001
11111111001
    1111111
