NO ./img/north.xpm
SO ./img/south.xpm
WE ./img/west.xpm
EA ./img/east.xpm
DO ./img/bricks.xpm

F 50,50,50
C 18,18,18

111111111111111111111
1110101111110000W0001
110000110111000000001
111000D0000D001111001
100000100001011111001
110001111D11111111001
100000011000011111D11
111D11110000011100011
110001110101011100011
110001111111111111111
111111111111111111111