NO ./img/TECH_0A_dark.xpm
SO ./img/TECH_0A_dark.xpm
WE ./img/TECH_0A.xpm
EA ./img/TECH_0A.xpm

DO ./img/DOOR_2C.xpm
W2 ./img/CONSOLE_1A.xpm
W3 ./img/CONSOLE_1A.xpm
W4 ./img/VENT_1B.xpm
W5 ./img/TECH_2B.xpm
W6 ./img/GRID_2B.xpm
W7 ./img/LIGHT_1B.xpm
W8 ./img/SUPPORT_1D.xpm
W9 ./img/PIPES_2A.xpm

F0 ./img/front0A.xpm
F1 ./img/front1A.xpm
F2 ./img/front2A.xpm
F3 ./img/front3A.xpm

A0 ./img/attack0A.xpm
A1 ./img/attack1A.xpm
A2 ./img/attack2A.xpm
A3 ./img/attack3A.xpm

D0 ./img/die0A.xpm
D1 ./img/die1A.xpm
D2 ./img/die2A.xpm
D3 ./img/die3A.xpm

BA ./img/BARREL.xpm
CA ./img/CABLES_1.xpm
PV ./img/health_v1.xpm

F 55,50,50
C 18,18,18

111111111111151111111
11000011111100CBBB00111
110C00190111000R0000101
110700D0R00D00113100101
1B0000100C01B1111100DC111111
110001161D111111110010100001
100C00011000011111D110D000W1
111D111100C00111BC011C100001
1100081101D10111BRC110111111
110H0111110B11111111101
11111111110000000000001
11H00000011011111111111
110000000D001
11B0000001111
11BR0000011
11B00000011
11111111111
