NO ./img/space_ship/TECH_0A_dark.xpm
SO ./img/space_ship/TECH_0A_dark.xpm
WE ./img/space_ship/TECH_0A.xpm
EA ./img/space_ship/TECH_0A.xpm

DO ./img/space_ship/DOOR_2C.xpm
W2 ./img/space_ship/CONSOLE_1C.xpm
W3 ./img/space_ship/TECH_3E_dark.xpm
W4 ./img/space_ship/VENT_1B.xpm
W5 ./img/space_ship/TECH_2B.xpm
W6 ./img/space_ship/GRID_1B.xpm
W7 ./img/space_ship/LIGHT_1B.xpm
W8 ./img/space_ship/SUPPORT_1D.xpm
W9 ./img/space_ship/TECH_3D.xpm

E0 ./img/space_ship/front0A.xpm
E1 ./img/space_ship/front1A.xpm
E2 ./img/space_ship/front2A.xpm
E3 ./img/space_ship/front3A.xpm

A0 ./img/space_ship/attack0A.xpm
A1 ./img/space_ship/attack1A.xpm
A2 ./img/space_ship/attack2A.xpm
A3 ./img/space_ship/attack3A.xpm

D0 ./img/space_ship/die0A.xpm
D1 ./img/space_ship/die1A.xpm
D2 ./img/space_ship/die2A.xpm
D3 ./img/space_ship/die3A.xpm

BA ./img/space_ship/BARREL.xpm
HA ./img/space_ship/CABLES_1.xpm
PV ./img/space_ship/health_v1.xpm

F 55,50,50
C 18,18,18

1111111111111111111111111111111111
1C00000000100000C0000000000000B111
1000000000D00000000000000000000111
10R000C000111D11111D11111D1110B111
10000000001BB0BB1BB0BB1BB0BB100111
10R00000001B000B1B000B1B000B10B111
100000C0001H0R00D00R00D00R0H100111
10000000001BBBBB1BBBBB1BBBBB10B111
11D1111111111111111111111111100111
1101111111111111111111111111D00111
1101BBB1B0H1C001000000111000011111
1101000100010001000C001B1000011111
110D0C0D000D0R0D000000D0D0R0011111
11010001C0010001000000101000011111
1101BBB1B0B10001000000101000011111
11D1111111111111111111101111111111
1000000000000001111BBB000000111111
10000000000000011110000000C0111111
1C00000C000000011110B0000000111111
1000000000000001111000000000111111
100111B000111001111000000000111001
100111R00011100D000000111000111001
100111B00011100111100011100000D0W1
1000000000000001111C00111000111001
10000000000000011110001110C0111001
1000000C00000001111000111000111111
1000000000000C01111000111000111111
1D11111111111111111000111000111111
1011111111111111111111111111111111
10111
1011111111111111111111111111111111
10111111111111111111111111111110H1
1C111111111111111111111111111110H1
10111111111111111111111111111110H1
10000000000000C000000R00000000D0H1
1111111111111111111111111111111111