NO ./img/LAB_1A.xpm
SO ./img/LAB_2A.xpm
WE ./img/LAB_3A.xpm
EA ./img/LAB_3B.xpm
DO ./img/DOOR_2C.xpm
W3 ./img/CONSOLE_1A.xpm
W4 ./img/VENT_1B.xpm
W5 ./img/TECH_2B.xpm
W6 ./img/GRID_2B.xpm
W7 ./img/LIGHT_1B.xpm
W8 ./img/SUPPORT_1D.xpm
W9 ./img/PIPES_2A.xpm

F 50,50,50
C 18,18,18

111111111111151111111
1110101111140000W0001
110000190111000000001
110700D0000D001131001
100000100001011111001
110001161D11111111001
100000011000011111D11
111D11110000011100011
110008110101011100011
110001111111111111111
111111111111111111111