NO ./img/TECH_0A_dark.xpm
SO ./img/TECH_0A_dark.xpm
WE ./img/TECH_0A.xpm
EA ./img/TECH_0A.xpm

DO ./img/DOOR_2C.xpm
W3 ./img/CONSOLE_1A.xpm
W4 ./img/VENT_1B.xpm
W5 ./img/TECH_2B.xpm
W6 ./img/GRID_2B.xpm
W7 ./img/LIGHT_1B.xpm
W8 ./img/SUPPORT_1D.xpm
W9 ./img/PIPES_2A.xpm
F1 ./img/front1.xpm
F2 ./img/front2.xpm
F3 ./img/front3.xpm
F4 ./img/front4.xpm
A1 ./img/attack1.xpm
A2 ./img/attack2.xpm
A3 ./img/attack3.xpm
D1 ./img/die1.xpm
D2 ./img/die2.xpm
D3 ./img/die3.xpm
BA ./img/BARREL.xpm
CA ./img/CABLES.xpm
F 55,50,50
C 18,18,18

111111111111111111111
111010111111011100101
110000100W01000000101
111000D0000D011100001
100011100001010111001
110011111D11100011001
100000011000100011D11
111D11010010010100011
1100010D0111010100011
1100010111110D0111111
111111111111111111111
