NO ./img/TECH_0A_dark.xpm
SO ./img/TECH_0A_dark.xpm
WE ./img/TECH_0A.xpm
EA ./img/TECH_0A.xpm

DO ./img/DOOR_2C.xpm
W2 ./img/CONSOLE_1A.xpm
W3 ./img/CONSOLE_1A.xpm
W4 ./img/VENT_1B.xpm
W5 ./img/TECH_2B.xpm
W6 ./img/GRID_2B.xpm
W7 ./img/LIGHT_1B.xpm
W8 ./img/SUPPORT_1D.xpm
W9 ./img/PIPES_2A.xpm

F0 ./img/front0A.xpm
F1 ./img/front1A.xpm
F2 ./img/front2A.xpm
F3 ./img/front3A.xpm

A0 ./img/attack0A.xpm
A1 ./img/attack1A.xpm
A2 ./img/attack2A.xpm
A3 ./img/attack3A.xpm

D0 ./img/die0A.xpm
D1 ./img/die1A.xpm
D2 ./img/die2A.xpm
D3 ./img/die3A.xpm

BA ./img/BARREL.xpm
CA ./img/CABLES_1.xpm

F 55,50,50
C 18,18,18

111111111111151111111
110000000001R0C0000C11
110C00190111B00000W0D01
110700D0000DC0113100101
1B0000100C01B11111001C1
110001161D1111111100101
100C00011000011111D1101
111D111100C00111B0011C1
1100081101D10111BCC1101
110C0111110B11111111101
11111111110000000000001
11000R00011111111111101
11000000011111111111101
11B000000111111111111011
110000000091111111111011
11B0000000011111111110111
111111110000000000000011
11111111111111111111111
